The Perplexing Puzzles of UNDOT
An Interactive Fiction Backdrop for a Mafia Game by CirclMastr
Release 1 / Serial number 240819 / Inform 7 v10.1.2 / D

Tower Courtyard
After a long journey through the countryside, you have come upon the UNDOT [ed. note - come up with better name than Un-Named Dungeon Or Tower for 1.0 release]. Its imposing black gates are suspiciously cast open, and you can see a path flanked by statues leading north to the door.

>n, n
Inner Courtyard
You find yourself surrounded on your left and right sides by white marble statues, eroded by time. Most are unrecognizable, but one statue of a treefolk person looking into the distance seems to have held up better than the others. Ahead of you, the stone path widens to a dais leading up to the castle doors. [ed. note - maybe add multiple floors if it's going to be a tower or castle.]

UNDOT Entrance
You step onto the raised dais, and see the great stone double doors that lead into the UNDOT. Decorations are carved into the stonework near your feet. A marble statue, toppled and broken, lies in front of the door.

>take all
marble head: Taken.
marble arm: Taken.
marble arm: Taken.

>put all on diamond
marble arm: The diamond sinks slightly, but otherwise nothing happens.
marble arm: The diamond sinks slightly, but otherwise nothing happens.
marble head: The combined weight of all three pieces is enough to depress the mechanism, and the door opens with a loud grinding sound.

>n, w
With no more obstacles to your progress, you enter the UNDOT.

The Grand Foyer
You enter the grand foyer of the UNDOT, which is grand mostly because of the grand staircase leading up to a door with an imposing lock. There are also doors to the West Wing and East Wing of the castle. The old adventuring credo of the Left Hand Rule would suggest going to the West Wing first.

Your score has gone up!

West Wing Foyer
You step into another, smaller foyer. Like the grand foyer, it is largely unfurnished. A stone door leads north, while the west wall features a row of levers. On the floor beneath the levers, you see the skeletal remains of an unfortunate adventurer who came before you. To the south, there is a life-sized statue of a human bard.

>take note
Taken.

>pull red
You pull the lever into the down position. As you do, the room fills with the sound of a ringing bell.

>pull black
You pull the lever into the down position. As you do, the room fills with the sound of a roaring lion.

>pull yellow
You pull the lever into the down position. As you do, the room fills with the sound of a buzzing bee.

>pull green
You pull the lever into the down position. As you do, the room fills with the sound of a rushing wind.

>pull blue
You pull the lever into the down position. As you do, the room fills with the sound of a strumming lute. As the sound of the lute fades away, the door open.

Your score has gone up!

>take chalice
Taken.

>n
West Wing Hall
You step into a long hallway, with a red carpet running north along the floor. On the western side of the hall is a statue of a dragonkin barbarian clad in furs, with a large battle-axe across its back.

>take axe
Taken.

>n
West Wing Hall 2
The carpet of the hall leads to a stone door, set into an archway covered with glyphs. A dead adventurer lies in front of the door.

>take scroll
Taken.

>push earth
You push the glyph, and the archstone sinks back flush to the wall. The first emerald on the door begins to glow.

>push fire
You push the glyph, and the archstone sinks back flush to the wall. The second emerald on the door begins to glow.

>push water
You push the glyph, and the archstone sinks back flush to the wall. The third emerald on the door begins to glow.

>push war
You push the glyph, and the archstone sinks back flush to the wall. The fourth emerald on the door begins to glow. Suddenly, the door lifts open.

Your score has gone up!

>n
Pedestal Room
You enter a room dominated by four waist-high pedestals, arranged in a 2x2 pattern. To the north is a featureless stone door.

(Hint: use compass directions to distinguish which pedestal you mean: NW, SW, NE, SE.) [Ed. note - come up with a readme or instruction manual for stuff like this.]

>take quill
Taken.

>write inverted reflected runes on sand
You move over to the northwest pillar and write in the sand. When you are finished, the door to the north slides open.

Your score has gone up!

>n
Mirrored Study
You enter a large study at the end of the west wing. The center is dominated by a dining table with seating and place settings for six. The northern wall has two bookshelves, separated by a writing desk. On the eastern wall is a large fireplace and mantle, flanked on one side by fireplace tools and on the other by a stone statue. The southern wall is decorated with ornamental weapons, and a suit of armor stands on either side of the southern door. The western wall is covered by a grand mirror that runs the entire width and height of the wall, and in front of the mirror lies a dead adventurer.

>put quill in ink
You set the quill into the pot of ink. It now matches its reflection in the mirror.

>put chalice on table
You set the golden chalice on the table. It now matches its reflection in the mirror.

>put axe on wall
You place the battle-axe on the wall with its mate. It now matches its reflection in the mirror.

>take page
Taken.

>put all in fireplace
torn-out page: Done.
scroll of glyphs: Done.
small piece of paper: Done.

>x tools
The fireplace tools include a poker, tongs, shovel, flint and steel, pan, and brush.

>take tools
Taken.

>light fire
You light the fire in the fireplace.

>drop tools
You place the fireplace tools next to the fireplace. It now matches its reflection in the mirror.

>take key
Taken.

Your score has gone up!

>s, s, s, s, e, e, n
Pedestal Room
You enter a room dominated by four waist-high pedestals, arranged in a 2x2 pattern. To the north is a featureless stone door.

West Wing Hall 2
The carpet of the hall leads to a stone door, set into an archway covered with glyphs. A dead adventurer lies in front of the door.

West Wing Hall
You step into a long hallway, with a red carpet running north along the floor. On the western side of the hall is a statue of a dragonkin barbarian clad in furs, with a large battle-axe across its back.

West Wing Foyer
You are standing in the foyer of the west wing of the UNDOT. A skeleton sits under five levers in the "down" position. An open door to the north leads further into the west wing. An open door to the east leads back to the Grand Foyer. Also the statue of the bard is still there.

The Grand Foyer
You enter the grand foyer of the UNDOT, which is grand mostly because of the grand staircase leading up to a door with an imposing lock. There are also doors to the West Wing and East Wing of the castle. The old adventuring credo of the Left Hand Rule would suggest going to the West Wing first.

East Wing Foyer
You enter a small foyer much like the Grand Foyer, just smaller. It is unfurnished, with a stone door to the north and a sign above the door.

(first opening the stone door)

East Wing Chasm
As you enter the room, you see that the floor ahead drops away suddenly into a deep chasm that stretches the entire width of the room. The ceiling above the chasm extends upward fifty feet. Hanging from that ceiling, you see several wooden platforms suspended on chains. The platforms are arranged in a scattered pattern of different locations and heights. Near the wall to the east, you see a group of six chains hanging from the ceiling. Each chain has a circular medallion hanging from the end of it.

>pull chain c
As you pull the chain, you feel resistance from springs and mechanical devices attached to the chain in the ceiling above. The sounds of gears grinding and chains moving echo off the walls of the chamber. You notice that one of the platforms hanging from the ceiling has changed position and moved closer to the ground, while another platform moved up toward the ceiling.

>pull chain f
As you pull the chain, you feel resistance from springs and mechanical devices attached to the chain in the ceiling above. The sounds of gears grinding and chains moving echo off the walls of the chamber. You notice that one of the platforms hanging from the ceiling has changed position and moved closer to the ground, while another platform moved up toward the ceiling.

>pull chain e
As you pull the chain, you feel resistance from springs and mechanical devices attached to the chain in the ceiling above. The sounds of gears grinding and chains moving echo off the walls of the chamber. You notice that one of the platforms hanging from the ceiling has changed position and moved closer to the ground, while another platform moved up toward the ceiling.

>pull chain a
As you pull the chain, the platforms adjust once again, moving up and down, and rotating in all directions. When the shapes finish moving, they come to a halt in a position that provides a bridge across the chasm.

Your score has gone up!

>n, n, n, s, s, n
You cross safely over the chasm.

East Wing Hallway
You step into a long, carpeted hallway. A single sconce illuminates the immediate area, while the rest of the hallway disappears into darkness to the north.

Darkness
It is pitch black. You are likely to be eaten by a grue.

Darkness
It is pitch black. You are likely to be eaten by a grue.

Darkness
It is pitch black. You are likely to be eaten by a grue.

East Wing Hallway, North
You approach a closed door illuminated by a single sconce. In the northwest corner of the room, you see a statue of an elven ranger with a bow and quiver slung across her back, arms spread wide in a friendly gesture.

Your score has gone up!

(first opening the stone door)

East Wing Vault
You enter what can only be described as a treasure vault belonging to a compulsive hoarder. The room is filled with stacks of boxes, chests of drawers, and safes all piled up in a way that looks barely stable, with narrow walkways between them. In one corner of the room, mannequins in armor are pressed together, while in another, statues are stacked and crammed together.

As you enter the room and look around at the treasures surrounding you, you fail to notice a stack of gold coins piled against the wall. You kick over the stack and send the coins scattering across the floor. Within moments, a small crab-like creation emerges from a nearby hole in the wall and heads toward the spilled coins. You notice that the creature is made up of various gears and springs as its claws work to pick up the coins and place them back in a stack. Once the coins are ordered, the automaton disappears back into the wall.

>drop key
You drop the golden key on the ground, and a clockwork crab scoops it up and carries it to a safe.

>open safe
You open the safe of keys, revealing a golden key and a silver key.

>take keys
golden key: Taken.
silver key: Taken.

Your score has gone up!

>s, s, s, n, n, s, s, w, up
East Wing Hallway, North
You approach a closed door illuminated by a single sconce. In the northwest corner of the room, you see a statue of an elven ranger with a bow and quiver slung across her back, arms spread wide in a friendly gesture.

Darkness
It is pitch black. You are likely to be eaten by a grue.

Darkness
It is pitch black. You are likely to be eaten by a grue.

Darkness
It is pitch black. You are likely to be eaten by a grue.

East Wing Hallway
You step into a long, carpeted hallway. A single sconce illuminates the immediate area, while the rest of the hallway disappears into darkness to the north.

East Wing Chasm
As you enter the room, you see that the floor ahead drops away suddenly into a deep chasm that stretches the entire width of the room. The ceiling above the chasm extends upward fifty feet. Hanging from that ceiling, you see several wooden platforms suspended on chains. The platforms seem to form a bridge across the chasm. Near the wall to the east, you see a group of six chains hanging from the ceiling. Each chain has a circular medallion hanging from the end of it.

East Wing Foyer
You enter a small foyer much like the Grand Foyer, just smaller. It is unfurnished, with a stone door to the north and a sign above the door.

The Grand Foyer
You enter the grand foyer of the UNDOT, which is grand mostly because of the grand staircase leading up to a door with an imposing lock. There are also doors to the West Wing and East Wing of the castle. The old adventuring credo of the Left Hand Rule would suggest going to the West Wing first.

Grand Balcony
You ascend the stairs to the grand balcony overlooking the foyer. There is a massive stone door, with an equally massive triangular lock system.

>unlock door with silver key
Row?

>13
Column?

>5
You turn the key, and one of the metal clamps on the door springs open.

>unlock door with gold key
Row?

>13
Column?

>9
You turn the key, and one of the metal clamps on the door springs open.

>unlock door with gold key
Row?

>5
Column?

>1
You turn the key, and one of the metal clamps on the door springs open.

>unlock door with silver key
Row?

>5
Column?

>5
You turn the key, and one of the metal clamps on the door springs open.

>n
(first opening the massive stone door)

Fresco Room
You enter an unfurnished room, with a door in the north wall fresco concealed in a painted fresco that covers all four walls of the room. The fresco depicts a tavern full of people of all sorts of races and social standings. On the east wall fresco, a bartender serves drinks to people sitting at the bar. On the west wall fresco, tables and chairs are full of patrons drinking, singing, and laughing together. On the south wall fresco, a bardic troupe plays for the tavern while people dance in front of them. On the north wall fresco, the tavern door is painted around an actual door, and patrons sit at tables playing dice and cards.

Your score has gone up!

>say All together we are the key
(to yourself)
When you finish speaking, the door in the north wall slides open.

>n
UNDOT Peak
You enter a luxuriously appointed room with fine furniture and rugs. At the center of the room is a small round table with a scroll sitting atop it, labeled "READ ME". Off to one side is a bar with flutes of champagne and a charcuterie board.

* * *

>say we the are key all together
(to yourself)
Nothing happens.

* * *

The Perplexing Puzzles of UNDOT
An Interactive Fiction Backdrop for a Mafia Game by CirclMastr
Release 1 / Serial number 240819 / Inform 7 v10.1.2 / D

Tower Courtyard
After a long journey through the countryside, you have come upon the UNDOT [ed. note - come up with better name than Un-Named Dungeon Or Tower for 1.0 release]. Its imposing black gates are suspiciously cast open, and you can see a path flanked by statues leading north to the door.

>x statues
From here, most of the statues appear to be in disrepair. You'll need to move closer to get a better look.

>move closer to the statues
From here, most of the statues appear to be in disrepair. You'll need to move closer to get a better look.

>i
Your pockets are like your mindscape: vast but empty.

>n
Inner Courtyard
You find yourself surrounded on your left and right sides by white marble statues, eroded by time. Most are unrecognizable, but one statue of a treefolk person looking into the distance seems to have held up better than the others. Ahead of you, the stone path widens to a dais leading up to the castle doors. [ed. note - maybe add multiple floors if it's going to be a tower or castle.]

>x treefolk statue
The treefolk statue stands tall, though its face is too weathered to read whether it is looking wistfully or expectantly into the distance. A few leaves carved in its hair have broken off, and its cloth garments suggest that this particular treefolk is no stranger to urban areas. As you look closer, it appears that one of the arms has lettering carved into it. The lettering is in a language you don't understand.

>sashay n
Sorry, I don't know how to sashay.

>x lettering
The lettering is in a language you don't understand.

>consult google
You can't see any such thing.

>take leaf
You can't see any such thing.

>n
UNDOT Entrance
You step onto the raised dais, and see the great stone double doors that lead into the UNDOT. Decorations are carved into the stonework near your feet. A marble statue, toppled and broken, lies in front of the door.

>x statue
The statue was once a humanoid figure, but any distinguishing marks were worn away long ago. The torso, head, and each arm are now separate pieces. The feet and base are nowhere to be seen.

>xyzzy
Do not cite the deep magic to me, I was there when it was written!

>shout
Your cry out to the heavens for succor, but receive no answer.

(Hint: If you're stuck, try to think about your problem!)

>elbereth
Sorry, I don't know how to elbereth.

>think lettering
You can't do anything with the lettering until you find a way to translate it.

>take arms
marble arm: Taken.
marble arm: Taken.

>flip torso
You try your best to lift the broken marble statue, but it's too heavy for you to move.

>take head
Taken.

>x stonework
The dominant carving is a large  diamond inlaid with three overlapping circles. Around and above it ("above" meaning it is between the diamond and the door) is an elaborate filigree pattern.

>knock on double doors
You knock on the great stone double doors, but there is no answer.

>flip torso with arms
I only understood you as far as wanting to flip the broken marble statue.

>x filigree pattern
At first glance, it appears to be purely decorative. After a few moments of study, however, it appears there is lettering in the filigree. The lettering is in a language you don't understand.

>stand in center circle
I only understood you as far as wanting to stand.

>break torso with head
You won't get anywhere by breaking things!

(Hint: If you're stuck, try to think about your problem!)

>look at self
You are a Newbie.

You currently have 0 points, out of a possible 10 points.

You are carrying:
  a marble head
  two marble arms

>open doors
You push with all your might, but the door doesn't budge.

>think about translation
There must be something inside the UNDOT that could help you with translation.

>pull doors
Sorry, I don't see anything to pull here.

>x doors
The double doors leading into the UNDOT are large, heavy, and imposing. There are no handles, no keyhole, and no hinges, so the door must swing inward. But the mechanism to open the door is not apparent.

>wake up
I don't see an up here. [Ed. note - insert an easter egg ending for this]

>x arm
The arm is broken off near the shoulder, and examining the break reveals it to be a solid piece of marble, not hollow. It weighs quite a bit on its own.

>think about entering the UNDOT
The mechanism to open the door must be on the dais somewhere. Have you looked at both the diamond and filigree?

>x diamond
The diamond is inlaid with three large circles that slightly overlap, forming a triangle inside the center of the diamond. A closer look at the stone itself reveals a small gap between the diamond and the rest of the stonework. It is apparently a separate piece, and not mortared to the other stones around it.

>jump on diamond
As you land on the diamond, it sinks downward, and a loud grinding sound echoes through the courtyard as the doors begin to open inward. When you jump upward and off the diamond, however, the diamond rises back up and the doors quickly slam fully shut.

>put head on diamond
The diamond sinks slightly, but otherwise nothing happens.

>put arms on diamond
marble arm: The diamond sinks slightly, but otherwise nothing happens.
marble arm: The combined weight of all three pieces is enough to depress the mechanism, and the door opens with a loud grinding sound.

>go doors
With no more obstacles to your progress, you enter the UNDOT.

The Grand Foyer
You enter the grand foyer of the UNDOT, which is grand mostly because of the grand staircase leading up to a door with an imposing lock. There are also doors to the West Wing and East Wing of the castle. The old adventuring credo of the Left Hand Rule would suggest going to the West Wing first.

Your score has gone up!

>x lock
You can't see any such thing.

>hunt scum
The ethical discussion around hunting and conservationism aside, you don't have a hunting permit.

>n
You can't go that way.

>w
West Wing Foyer
You step into another, smaller foyer. Like the grand foyer, it is largely unfurnished. A stone door leads north, while the west wall features a row of levers. On the floor beneath the levers, you see the skeletal remains of an unfortunate adventurer who came before you. To the south, there is a life-sized statue of a human bard.

>x levers
There are five levers with colored handles, all in the "up" position. From left to right, the levers are black, yellow, blue, green and red.

>x statue
The statue is of a human bard strumming a lute. She is wearing a fancy cap with a feather in it and her mouth is open in song. As you look closer, the neck of the lute has lettering carved into it. The lettering is the word "The" in the common tongue.

>x skeleton
The skeleton is old and skeletonized enough that you cannot tell how they died. One hand is gripping a small golden chalice; the other is gripping a small piece of paper.

>x paper
The paper seems to be a small hand-written note. You can't read it without taking it from the skeleton's grasp.

>x chalice
The chalice is small and made of gold, with a silver band around the stem.

>x lute
The lute is carved out of marble, like the rest of the statue. As you look closer, the neck of the lute has lettering carved into it. The lettering is the word "The" in the common tongue.

>take paper
Taken.

>x paper
The paper reads:

The second lever will sound like a roar
A primary first helps open the door
The last lever pulled is the color of sky
After the second will buzz like a fly

>x self
You are a Beginner.

You currently have 1 points, out of a possible 10 points.

You are carrying:
  a hand-written note

>x silver band
It appears to be a simple decorative band.

>x levers
There are five levers with colored handles, all in the "up" position. From left to right, the levers are black, yellow, blue, green and red.

>take chalice
Taken.

>ring chalice
Tink.

>pull red
You pull the lever into the down position. As you do, the room fills with the sound of a ringing bell.

* * *

>pull black
You pull the lever into the down position. As you do, the room fills with the sound of a roaring lion.

>pull green
You pull the lever into the down position. As you do, the room fills with the sound of a rushing wind.

>think about chalice
You're not thirsty right now, but it might come in handy later.

>look at stone door
The stone door is a featureless slab within the doorframe. Based on the very slight gap at the bottom, you can surmise that the door lifts up somehow.

>e
The Grand Foyer
You enter the grand foyer of the UNDOT, which is grand mostly because of the grand staircase leading up to a door with an imposing lock. There are also doors to the West Wing and East Wing of the castle. The old adventuring credo of the Left Hand Rule would suggest going to the West Wing first.

>e
East Wing Foyer
You enter a small foyer much like the Grand Foyer, just smaller. It is unfurnished, with a stone door to the north and a sign above the door.

>read sign
The sign reads:

"WARNING: If you are not a Greenhorn, turn back!"

>x door
The stone door is unadorned save for its iron ring pull.

>w
The Grand Foyer
You enter the grand foyer of the UNDOT, which is grand mostly because of the grand staircase leading up to a door with an imposing lock. There are also doors to the West Wing and East Wing of the castle. The old adventuring credo of the Left Hand Rule would suggest going to the West Wing first.

>w
West Wing Foyer
You step into another, smaller foyer. Like the grand foyer, it is largely unfurnished. A stone door leads north, while the west wall features a row of levers. On the floor beneath the levers, you see the skeletal remains of an unfortunate adventurer who came before you. To the south, there is a life-sized statue of a human bard.

>x levers
There are five levers with colored handles. From left to right, the levers are black (down), yellow (up), blue (up), green (down) and red (down).

>pull yellow
You pull the lever into the down position. As you do, the room fills with the sound of a buzzing bee.

>pull blue
You pull the lever into the down position. As you do, the room fills with the sound of a strumming lute. A bright bolt of energy shoots from the levers, hitting the skeleton and disintegrating it. After that, all the levers reset to the "up" position.

>pull red
You pull the lever into the down position. As you do, the room fills with the sound of a ringing bell.

* * *

>pull blue
You pull the lever into the down position. As you do, the room fills with the sound of a strumming lute. As the sound of the lute fades away, the door open.

Your score has gone up!

>look
West Wing Foyer
You are standing in the foyer of the west wing of the UNDOT. A small pile of dust that used to be a skeleton sits under five levers in the "down" position. An open door to the north leads further into the west wing. An open door to the east leads back to the Grand Foyer. Also the statue of the bard is still there.

>x self
You are a Rookie.

You currently have 2 points, out of a possible 10 points.

You are carrying:
  a small golden chalice
  a hand-written note

>n
West Wing Hall
You step into a long hallway, with a red carpet running north along the floor. On the western side of the hall is a statue of a dragonkin barbarian clad in furs, with a large battle-axe across its back.

>x axe
The glint of the axe suggests it is surprisingly sharp. Wait a minute, the axe isn't marble! It's not actually a part of the statue!

>x carpet
The carpet is a cool red color, without much frill or decoration. It must be here for comfort, since there's not much style to it and it's impossible to get lost in a hallway.

>take axe
Taken.

* * *

>n
West Wing Hall 2
The carpet of the hall leads to a stone door, set into an archway covered with glyphs. A dead adventurer lies in front of the door.

>x adventurer
The adventurer is long dead, a humanoid skeleton clad in tatters. In its bony fingers, it grips a scroll.

>x glyphs
There are sixteen glyphs, each on a stone that makes up the archway around the door.

>take scroll
Taken.

>read scroll
You unfurl the scroll, and see that the adventurer had translated the glyphs. Of course, he didn't solve the puzzle, so how much help could it really be?

>s, s, e, s
West Wing Hall
You step into a long hallway, with a red carpet running north along the floor. On the western side of the hall is a statue of a dragonkin barbarian clad in furs.

West Wing Foyer
You are standing in the foyer of the west wing of the UNDOT. A small pile of dust that used to be a skeleton sits under five levers in the "down" position. An open door to the north leads further into the west wing. An open door to the east leads back to the Grand Foyer. Also the statue of the bard is still there.

The Grand Foyer
You enter the grand foyer of the UNDOT, which is grand mostly because of the grand staircase leading up to a door with an imposing lock. There are also doors to the West Wing and East Wing of the castle. The old adventuring credo of the Left Hand Rule would suggest going to the West Wing first.

UNDOT Entrance
You step onto the raised dais, and see the great stone double doors that lead into the UNDOT. Decorations are carved into the stonework near your feet. A marble statue torso, toppled and broken, lies in front of the door.

>x decorations
The dominant carving is a large  diamond inlaid with three overlapping circles. Around and above it ("above" meaning it is between the diamond and the door) is an elaborate filigree pattern.

>x filigree
At first glance, it appears to be purely decorative. After a few moments of study, however, it appears there is lettering in the filigree. The lettering is in a language you don't understand.

>x scroll
You unfurl the scroll, and see that the adventurer had translated the glyphs. Of course, he didn't solve the puzzle, so how much help could it really be?

>read filigree
At first glance, it appears to be purely decorative. After a few moments of study, however, it appears there is lettering in the filigree. The lettering is in a language you don't understand.

>think glyphs
While letters might technically qualify as "glyphs", the glyphs on the note are not the same as any lettering you've seen.

>n
The Grand Foyer
You enter the grand foyer of the UNDOT, which is grand mostly because of the grand staircase leading up to a door with an imposing lock. There are also doors to the West Wing and East Wing of the castle. The old adventuring credo of the Left Hand Rule would suggest going to the West Wing first.

>climb staircase
You were never very athletic, so climbing is not in your wheelhouse.

>up
Grand Balcony
You ascend the stairs to the grand balcony overlooking the foyer. There is a massive stone door, with an equally massive triangular lock system.

>x lock
The lock is a large triangle, inset with a pyramid of 120 keyholes. At each corner of the triangle is a stylized star symbol.

>x door
The stone door is held shut by four clamps, one in each corner of the door.

>x foyer
You look over the balcony, and immediately regret it. You don't want to fall that far!

>down, w, n, n
The Grand Foyer
You enter the grand foyer of the UNDOT, which is grand mostly because of the grand staircase leading up to a door with an imposing lock. There are also doors to the West Wing and East Wing of the castle. The old adventuring credo of the Left Hand Rule would suggest going to the West Wing first.

West Wing Foyer
You are standing in the foyer of the west wing of the UNDOT. A small pile of dust that used to be a skeleton sits under five levers in the "down" position. An open door to the north leads further into the west wing. An open door to the east leads back to the Grand Foyer. Also the statue of the bard is still there.

West Wing Hall
You step into a long hallway, with a red carpet running north along the floor. On the western side of the hall is a statue of a dragonkin barbarian clad in furs.

West Wing Hall 2
The carpet of the hall leads to a stone door, set into an archway covered with glyphs. A dead adventurer lies in front of the door.

>x adventurer
The adventurer is long dead, a humanoid skeleton clad in tatters.

>x axe
The axe is in pristine condition, with a sharp edge and no sign of wear. It's easy to tell that no one has actually used this axe in combat.

>push safe passage
You push the glyph, and the archstone sinks back flush to the wall. A ruby on the door begins to glow.

>push fire
You push the glyph, and the archstone sinks back flush to the wall. The second emerald on the door begins to glow.

>push earth
You push the glyph, and the archstone sinks back flush to the wall. The first emerald on the door begins to glow.

>x door
The door is dominated by a carving of a sword, which eclipses a circle with a sun and moon along its arc.  Beneath the carving, there are handwritten scrawls in red ink. Above the carving are two rows of gems: four emeralds above three rubies. The first emerald, the second emerald and the first ruby are glowing with magical light.

>push sun
You push the glyph, and the archstone sinks back flush to the wall. A ruby on the door begins to glow.

>think glyphs
It is clear the glyphs open the door, and you can surmise from the behavior of the gems that either four are correct and order matters, or three are correct and order doesn't matter.

>x scrawls
The scrawls are faded with time, but you can make out "Life of a sword? Birth of a sword?"

>push war
You push the glyph, and the archstone sinks back flush to the wall. The fourth emerald on the door begins to glow.

>push death
You push the glyph, and the archstone sinks back flush to the wall. A ruby on the door begins to glow. Suddenly, a bolt of magical energy shoots out from the carving, disintegrating the remains of the dead adventurer. All the archstones that were pressed reset to their original positions, and all the gems stop glowing.

>push water
You push the glyph, and the archstone sinks back flush to the wall. The third emerald on the door begins to glow.

>push earth
You push the glyph, and the archstone sinks back flush to the wall. The first emerald on the door begins to glow.

>push war
You push the glyph, and the archstone sinks back flush to the wall. The fourth emerald on the door begins to glow.

>push fire
You push the glyph, and the archstone sinks back flush to the wall. The second emerald on the door begins to glow. Suddenly, a bolt of magical energy shoots out from the carving, striking you in the chest. The pain is brief, but tremendous. All the archstones that were pressed reset to their original positions, and all the gems stop glowing.

[Your blood pressure just went up!]

>push earth
You push the glyph, and the archstone sinks back flush to the wall. The first emerald on the door begins to glow.

* * *

>push war
You push the glyph, and the archstone sinks back flush to the wall. The fourth emerald on the door begins to glow. Suddenly, the door lifts open.

Your score has gone up!

>x self
You are a Novice.

You currently are Annoyed.

You currently have 3 points, out of a possible 10 points.

You are carrying:
  a scroll of glyphs
  a battle-axe
  a small golden chalice
  a hand-written note

>n
Pedestal Room
You enter a room dominated by four waist-high pedestals, arranged in a 2x2 pattern. To the north is a featureless stone door.

(Hint: use compass directions to distinguish which pedestal you mean: NW, SW, NE, SE.) [Ed. note - come up with a readme or instruction manual for stuff like this.]

>x sw pedestal
You see a series of runes carved into the top surface of the pedestal, with a horizontal line below them.

>x nw pedestal
This pedestal has a stone bowl embedded in its top. The bowl is filled with fine white sand, the surface of which is smooth and flat.

>x ne pedestal
Atop this pedestal rests a feather quill.

>x se pedestal
Atop this pedestal rests a piece of a broken sword blade, its surface highly polished.

>x runes
You see nothing special about the runes.

>take quill
Taken.

>write something on sword
The broken sword is now slightly less polished.

>x bowl
The bowl is filled with fine white sand, the surface of which is smooth and flat.

>take broken sword
Taken.

>think about where to write
Having a quill with no ink, there's only one way to write anything, and that's in the sand.

>put sword on runes
The broken sword fits neatly on the line beneath the runes.

>x sword
Looking down at the sword from where you are, you see the runes inverted in the polished blade's reflection.

>write inverted runes in sand
You move over to the northwest pillar and write in the sand. When you are finished, a gust of wind suddenly rises up around the pillar. The sand in the bowl is blown smooth and flat once again.

>think about inverted runes
Do the runes look the same from the north as from the south?

>x sword from north
You look at the sword's reflection from the north, by the bowl of sand. Inverted and reflected in the sword's blade, the runes appear as such:

>write flame in sand
You move over to the northwest pillar and write in the sand. When you are finished, a gust of wind suddenly rises up around the pillar. The sand in the bowl is blown smooth and flat once again.

>think about sand
You need to write something in the sand. Standing by the sand, you see inverted reflected runes on the sword blade.

>write reflected runes in sand
You move over to the northwest pillar and write in the sand. When you are finished, a gust of wind suddenly rises up around the pillar. The sand in the bowl is blown smooth and flat once again.

>think about how to alter the runes
If you look at the runes from the bowl of sand in the blade's reflection, they are both reflected and inverted.

>write reflected and inverted runes in sand
You move over to the northwest pillar and write in the sand. When you are finished, the door to the north slides open.

Your score has gone up!

>i
You are carrying:
  a feather quill
  a scroll of glyphs
  a battle-axe
  a small golden chalice
  a hand-written note

>n
Mirrored Study
You enter a large study at the end of the west wing. The center is dominated by a dining table with seating and place settings for six. The northern wall has two bookshelves, separated by a writing desk. On the eastern wall is a large fireplace and mantle, flanked on one side by fireplace tools and on the other by a stone statue. The southern wall is decorated with ornamental weapons, and a suit of armor stands on either side of the southern door. The western wall is covered by a grand mirror that runs the entire width and height of the wall, and in front of the mirror lies a dead adventurer.

>x self
You are an Amateur.

You currently are Annoyed.

You currently have 4 points, out of a possible 10 points.

You are carrying:
  a feather quill
  a scroll of glyphs
  a battle-axe
  a small golden chalice
  a hand-written note

>x dead adventurer
The adventurer's body is collapsed in front of the mirror. Given its emaciated state, it's entirely possible the adventurer starved to death in this room. In its hand is a torn-out page.

>x desk
It is a small writing desk with a single chair. A pot of ink sits in a corner of the desk.

>x fireplace
The fireplace is unlit, though wood has been stacked inside in preparation for lighting it. The mantle above it is empty.

>x mirror
The mirror reflects the entire room, and you could look at anything in the room in the mirror.

>x armor
Each suit of armor is a set of full plate, sized to fit a halfling or gnome, so it's much too small for you to wear.

>x statue
The statue depicts a smiling halfling, lifting a mug of ale in the air as a toast. Across the face of the mug is lettering. The lettering is in a language you don't understand.

>x bookshelves
The bookshelves reach the height of the ceiling and, barring the space in between for the writing desk, cover the entire width of the wall. They seem to be sorted by author rather than subject, and no gaps indicate any missing books.

>take fireplace tools
Taken.

>x table
The table has chairs and place settings for six people, with plates, silverware, and folded napkins all laid out. There is no food or drink on the table.

>take page
Taken.

>x page
The page appears to be from a journal. Most of the writing is unhinged, the author wondering if they are real or if they're trapped in the mirror and what they see as the reflection is actually the real world. One bit does stand out, however. "The key is the key. It's on the mantle, but it's not."

>x mug in mirror
The lettering is in a language you don't understand.

>x table in mirror
The table has chairs and place settings for six people, with plates, silverware, and folded napkins all laid out. A decorative golden chalice sits in the middle of the table. There is no food or drink on the table.

>attack armor
The armor, whose interlocking plates are designed to deflect blades, deflects the blade.

>x fireplace in mirror
The fireplace is lit, with a gently burning fire illuminating the study. The mantle above it is empty save for a gold key.

>fill quill with ink
You dip the feather quill into the pot of ink.

>give axe to armor
The armor, being empty, cannot take anything.

>take key
You can't see any such thing.

>take key from mirror
You put your hand against the mirror, feel silly, and pull your hand away again.

>put chalice on table
You set the golden chalice on the table. It now matches its reflection in the mirror.

>x fireplace tools
The fireplace tools include a poker, tongs, shovel, flint and steel, pan, and brush.

>x bookshelves in mirror
The bookshelves reach the height of the ceiling and, barring the space in between for the writing desk, cover the entire width of the wall. They seem to be sorted by author rather than subject, and no gaps indicate any missing books.

>x mug in mirror
The lettering is in a language you don't understand.

>x desk in mirror
It is a small writing desk with a single chair. A pot of ink and quill sits in a corner of the desk.

>light fire
You create sparks, but the logs don't catch fire.

>x self in mirror
You are an Amateur.

You currently are Annoyed.

You currently have 4 points, out of a possible 10 points.

You are carrying:
  a torn-out page
  some fireplace tools
  a feather quill
  a scroll of glyphs
  a battle-axe
  a hand-written note

>put quill in pot
You set the quill into the pot of ink. It now matches its reflection in the mirror.

>put page in fireplace
You put the torn-out page into the large fireplace.

>light fire
You think about lighting it, but you want to make sure you have enough kindling first.

>think about fireplace
Do you have anything flammable from previously solved puzzles?

>x note
You reminisce about solving the earlier puzzle.

>x scroll
You reminisce about solving the earlier puzzle.

>put note in fireplace
You put the hand-written note into the large fireplace.

>put scroll in fireplace
You put the scroll of glyphs into the large fireplace.

>light fire
You light the fire in the fireplace.

>think about golden key
If only you could make the room match its reflection...

>compare fireplace to mirror fireplace
Sorry, I don't know how to compare.

>x ornamental weapons
There are a variety of ornamental weapons on the wall, including a pair of crossed swords, a bow, a battle-axe, and a long jousting lance.

>x tools in mirror
The fireplace tools include a poker, tongs, shovel, flint and steel, pan, and brush.

>x fireplace in mirror
The fireplace is lit, with a gently burning fire illuminating the study. The mantle above it is empty save for a gold key.

>x dead adventurer in mirror
The adventurer's body is collapsed in front of the mirror. Given its emaciated state, it's entirely possible the adventurer starved to death in this room.

>x dead adventurer
The adventurer's body is collapsed in front of the mirror. Given its emaciated state, it's entirely possible the adventurer starved to death in this room.

>put fireplace tools down
You place the fireplace tools next to the fireplace. It now matches its reflection in the mirror.

>x weapons in mirror
There are a variety of ornamental weapons on the wall, including a pair of crossed swords, a bow, a pair of crossed battle-axes, and a long jousting lance.

>place battle-axe on wall
You place the battle-axe on the wall with its mate. It now matches its reflection in the mirror.

>x southern wall in mirror
There are a variety of ornamental weapons on the wall, including a pair of crossed swords, a bow, a pair of crossed battle-axes, and a long jousting lance.

>search dead adventurer
The adventurer's body is collapsed in front of the mirror. Given its emaciated state, it's entirely possible the adventurer starved to death in this room.

>x southern wall
There are a variety of ornamental weapons on the wall, including a pair of crossed swords, a bow, a pair of crossed battle-axes, and a long jousting lance.

>x mantle
The fireplace is lit, with a gently burning fire illuminating the study. The mantle above it is empty save for a golden key.

>take key
Taken.

Your score has gone up!

>x door
You see nothing special about the stone door.

>x self
You are a Greenhorn.

You currently are Annoyed.

You currently have 5 points, out of a possible 10 points.

You are carrying:
  a golden key

>s,s,s,s,e,e
Pedestal Room
You enter a room dominated by four waist-high pedestals, arranged in a 2x2 pattern. To the north is a featureless stone door.

West Wing Hall 2
The carpet of the hall leads to a stone door, set into an archway covered with glyphs. A pile of dust lies in front of the door.

West Wing Hall
You step into a long hallway, with a red carpet running north along the floor. On the western side of the hall is a statue of a dragonkin barbarian clad in furs, with a large battle-axe across its back.

West Wing Foyer
You are standing in the foyer of the west wing of the UNDOT. A small pile of dust that used to be a skeleton sits under five levers in the "down" position. An open door to the north leads further into the west wing. An open door to the east leads back to the Grand Foyer. Also the statue of the bard is still there.

The Grand Foyer
You enter the grand foyer of the UNDOT, which is grand mostly because of the grand staircase leading up to a door with an imposing lock. There are also doors to the West Wing and East Wing of the castle. The old adventuring credo of the Left Hand Rule would suggest going to the West Wing first.

East Wing Foyer
You enter a small foyer much like the Grand Foyer, just smaller. It is unfurnished, with a stone door to the north and a sign above the door.

>open door
You open the stone door.

>n
East Wing Chasm
As you enter the room, you see that the floor ahead drops away suddenly into a deep chasm that stretches the entire width of the room. The ceiling above the chasm extends upward fifty feet. Hanging from that ceiling, you see several wooden platforms suspended on chains. The platforms are arranged in a scattered pattern of different locations and heights. Near the wall to the east, you see a group of six chains hanging from the ceiling. Each chain has a circular medallion hanging from the end of it.

>x medallions
Each medallion has markings painted onto it.

>x platforms
The platforms are arranged in a scattered pattern of different locations and heights. Some are very close to the ceiling, while others are only twenty feet above you.

>pull medallion b
As you pull the chain, you feel resistance from springs and mechanical devices attached to the chain in the ceiling above. The sounds of gears grinding and chains moving echo off the walls of the chamber. You notice that one of the platforms hanging from the ceiling has changed position and moved closer to the ground, while another platform moved up toward the ceiling.

>pull medallion d
As you pull the chain, you feel resistance from springs and mechanical devices attached to the chain in the ceiling above. The sounds of gears grinding and chains moving echo off the walls of the chamber. You notice that one of the platforms hanging from the ceiling has changed position and moved closer to the ground, while another platform moved up toward the ceiling.

>look chasm
Looking over the edge, you see nothing but darkness. The pit descends down further than you can see.

>look ceiling
The ceiling above the chasm extends upward fifty feet. Hanging from that ceiling, you see several wooden platforms suspended on chains.

>think about platforms
You can't brute-force the puzzle by watching the platforms move.

>think about medallions
The paintings on the medallions must hint at the order to pull the chains.

>think about medallions
They seem to depict a celestial body moving through the sky.

>pull medallion a
As you pull the chain, you feel resistance from springs and mechanical devices attached to the chain in the ceiling above. The sounds of gears grinding and chains moving echo off the walls of the chamber. You notice that one of the platforms hanging from the ceiling has changed position and moved closer to the ground, while another platform moved up toward the ceiling.

>pull medallion c
As you pull the chain, you feel resistance from springs and mechanical devices attached to the chain in the ceiling above. The sounds of gears grinding and chains moving echo off the walls of the chamber. You notice that one of the platforms hanging from the ceiling has changed position and moved closer to the ground, while another platform moved up toward the ceiling.

The chains that you've pulled begin to retract again, the platforms shifting back to their original positions near the ceiling. A sudden gust of wind erupts behind you, and you almost get blown into the chasm by the force of the magical gale. By the time you recover, it seems the entire puzzle has reset.

[Your blood pressure just went up!]

>pull medallion c
As you pull the chain, you feel resistance from springs and mechanical devices attached to the chain in the ceiling above. The sounds of gears grinding and chains moving echo off the walls of the chamber. You notice that one of the platforms hanging from the ceiling has changed position and moved closer to the ground, while another platform moved up toward the ceiling.

>pull medallion f
As you pull the chain, you feel resistance from springs and mechanical devices attached to the chain in the ceiling above. The sounds of gears grinding and chains moving echo off the walls of the chamber. You notice that one of the platforms hanging from the ceiling has changed position and moved closer to the ground, while another platform moved up toward the ceiling.

>pull medallion e
As you pull the chain, you feel resistance from springs and mechanical devices attached to the chain in the ceiling above. The sounds of gears grinding and chains moving echo off the walls of the chamber. You notice that one of the platforms hanging from the ceiling has changed position and moved closer to the ground, while another platform moved up toward the ceiling.

>pull medallion a
As you pull the chain, the platforms adjust once again, moving up and down, and rotating in all directions. When the shapes finish moving, they come to a halt in a position that provides a bridge across the chasm.

Your score has gone up!

>n
You cross safely over the chasm.

East Wing Hallway
You step into a long, carpeted hallway. A single sconce illuminates the immediate area, while the rest of the hallway disappears into darkness to the north.

>x self
You are a Neophyte.

You currently are Irritated.

You currently have 6 points, out of a possible 10 points.

You are carrying:
  a golden key

>x sconce
The sconce is made predominantly of iron, with thin metal bands wrapped decoratively around a glowing crystal.

>take sconce
Try as you might, you are unable to pull the sconce from the wall.

>take crystal
Unsurprisingly, you cannot bend iron with your bare hands.

>think about hallway
There's only one way to go, right?

>n, n, s, s
Darkness
It is pitch black. You are likely to be eaten by a grue.

Darkness
It is pitch black. You are likely to be eaten by a grue.

Darkness
It is pitch black. You are likely to be eaten by a grue.

East Wing Hallway, North
You approach a closed door illuminated by a single sconce. In the northwest corner of the room, you see a statue of an elven ranger with a bow and quiver slung across her back, arms spread wide in a friendly gesture.

Your score has gone up!

>think about scones
Scones without some kind of spread or topping are basically a food crime.

>x statue
It is a stone statue of an elven ranger with a bow and quiver slung across her back, arms spread wide in a friendly gesture. Across her sleeve is some lettering. The lettering is in a language you don't understand.

>take bow and quiver
The statue is too heavy for you to lift.

>reciprocate gesture to statue
Sorry, I don't know how to reciprocate.

>think about statue
Eventually, you'll need to find a translation guide.

>x lettering
The lettering is in a language you don't understand.

>x door
It is a simple stone door with an iron handle, set in the north wall.

>open door
The door opens easily enough.

>x self
You are a Trainee.

You currently are Irritated.

You currently have 7 points, out of a possible 10 points.

You are carrying:
  a golden key

>look through door
It is a simple stone door with an iron handle, set in the north wall.

>think about titles for players with 6 points
There's nothing wrong with being a Trainee.

>n
East Wing Vault
You enter what can only be described as a treasure vault belonging to a compulsive hoarder. The room is filled with stacks of boxes, chests of drawers, and safes all piled up in a way that looks barely stable, with narrow walkways between them. In one corner of the room, mannequins in armor are pressed together, while in another, statues are stacked and crammed together.

As you enter the room and look around at the treasures surrounding you, you fail to notice a stack of gold coins piled against the wall. You kick over the stack and send the coins scattering across the floor. Within moments, a small crab-like creation emerges from a nearby hole in the wall and heads toward the spilled coins. You notice that the creature is made up of various gears and springs as its claws work to pick up the coins and place them back in a stack. Once the coins are ordered, the automaton disappears back into the wall.

>x mannequins
The mannequins aren't exactly posed well to show off the armor on them, like the ones from the study were.

>x statues
Most of the statues are the same sort of stone statues that have appeared throughout the UNDOT. One of the statues is of a dwarf priest in long, flowing robes, with hands folded in prayer and a small book with lettering on the cover hanging from his belt. The lettering is in a language you don't understand. Another one... isn't a statue at all, but is a dead adventurer. The automatons must have mistaken the corpse for a statue.

>x dead adventurer
The adventurer looks emaciated, much like the one that starved to death in the study. At first glance, you think the automatons must have sorted away all his possessions, but then you find a small note they must have missed.

>x hole
If you didn't know better, you'd think it was just mice or rats that made the hole.

>read note
(first taking the note)
It is partially damaged from age, but you can make out "...keys at the end of each wing. I'll find the west wing key, you find the east...".

A crab-like automaton snatches the note from your hand. You watch as it marches to one box in particular and slips the note inside. The automaton then returns to wherever it goes inside the wall.

>open box note was in
You open the box of notes, revealing a note.

>take note
Taken.

>take armor from mannequins
That would be stealing, and stealing is wrong.

>x box note was in
It looks like all the other boxes around it.

>search box note was in
It's full of other scraps of paper, most of which are in languages you don't understand.

>x coins
They are small gold coins, stamped with the face of a person you don't recognize. They're probably currency of some foreign nation.

>look in hole
Darkness
It is pitch black. You are likely to be- nevermind.

>drop key
You drop the golden key on the ground, and a clockwork crab scoops it up and carries it to a safe.

>open safe key was taken to
You open the safe of keys, revealing a golden key and a silver key.

>take keys
golden key: Taken.
silver key: Taken.

Your score has gone up!

With no more need for the note, you drop it on the floor for the automaton to sort.

>x self
You are a Postulant.

You currently are Irritated.

You currently have 8 points, out of a possible 10 points.

You are carrying:
  a silver key
  a golden key

>exits
There is an exit to the south.

>take note
That would be stealing, and stealing is wrong.

>s, s, z, n, s, s, n, n
East Wing Hallway, North
You approach a closed door illuminated by a single sconce. In the northwest corner of the room, you see a statue of an elven ranger with a bow and quiver slung across her back, arms spread wide in a friendly gesture.

Darkness
It is pitch black. You are likely to be eaten by a grue.

Time passes.

East Wing Hallway, North
You approach a closed door illuminated by a single sconce. In the northwest corner of the room, you see a statue of an elven ranger with a bow and quiver slung across her back, arms spread wide in a friendly gesture.

Darkness
It is pitch black. You are likely to be eaten by a grue.

Darkness
It is pitch black. You are likely to be eaten by a grue.

Darkness
It is pitch black. You are likely to be eaten by a grue.

East Wing Hallway
You step into a long, carpeted hallway. A single sconce illuminates the immediate area, while the rest of the hallway disappears into darkness to the north.

>x keys
You can't use multiple objects with that verb.

>s
East Wing Chasm
As you enter the room, you see that the floor ahead drops away suddenly into a deep chasm that stretches the entire width of the room. The ceiling above the chasm extends upward fifty feet. Hanging from that ceiling, you see several wooden platforms suspended on chains. The platforms seem to form a bridge across the chasm. Near the wall to the east, you see a group of six chains hanging from the ceiling. Each chain has a circular medallion hanging from the end of it.

>x silver key
It is a large key coated with silver. On its shaft is written, "Five to the right, with three in between."

>x gold key
It is a large key coated with gold. On its shaft is written, "Five to the left, with three in between."

>s, w, up
East Wing Foyer
You enter a small foyer much like the Grand Foyer, just smaller. It is unfurnished, with a stone door to the north and a sign above the door.

The Grand Foyer
You enter the grand foyer of the UNDOT, which is grand mostly because of the grand staircase leading up to a door with an imposing lock. There are also doors to the West Wing and East Wing of the castle. The old adventuring credo of the Left Hand Rule would suggest going to the West Wing first.

Grand Balcony
You ascend the stairs to the grand balcony overlooking the foyer. There is a massive stone door, with an equally massive triangular lock system.

>think about lock
How many of the 120 locks need to be unlocked?

>think about keys
You have all the keys.

>think about stars on door
Sometimes a star is just a star.

>unlock door with gold key
Row?

>15
Column?

>6
You turn the key. You see no change to the door, but hear a sound of metal against stone that lasts for a few seconds.

>unlock door with silver key
Row?

>15
Column?

>10
You turn the key. You see no change to the door, but hear a sound of metal against stone that lasts for a few seconds.

>unlock door with silver key
Row?

* * *

>9
You turn the key, and one of the metal clamps on the door springs open.

>unlock door with silver key
Row?

* * *

>13
Column?

>5
You turn the key, and one of the metal clamps latches back onto the door.

>unlock door with gold key
Row?

* * *

>13
Column?

>9
You turn the key, and one of the metal clamps latches back onto the door.

>unlock door with silver key
Row?

* * *

>9
You turn the key, and one of the metal clamps on the door springs open.

>open door
It seems to be locked.

>exits
There are exits to the north and the down.

>x door
The stone door is held shut by four clamps, one in each corner of the door. Two of the clamps are open.

>unlock door with gold key
Row?

* * *

>5
You turn the key, and one of the metal clamps on the door springs open.

>open door
You open the massive stone door. You see behind it a large metal slab covering the top forty percent of the doorway. Fortunately, it isn't enough to stop you from ducking under it to get through the door.

>n
Fresco Room
You enter an unfurnished room, with a door in the north wall fresco concealed in a painted fresco that covers all four walls of the room. The fresco depicts a tavern full of people of all sorts of races and social standings. On the east wall fresco, a bartender serves drinks to people sitting at the bar. On the west wall fresco, tables and chairs are full of patrons drinking, singing, and laughing together. On the south wall fresco, a bardic troupe plays for the tavern while people dance in front of them. On the north wall fresco, the tavern door is painted around an actual door, and patrons sit at tables playing dice and cards.

Your score has gone up!

>x closed door
The closed door is flush to the wall, with no visible handle, keyhole, or other means of opening it.

>x east wall fresco
On the east wall, a bartender serves drinks to people sitting at the bar.

>x west wall fresco
On the west wall, tables and chairs are full of patrons drinking, singing, and laughing together.

>x self
You are an Apprentice.

You currently are Irritated.

You currently have 9 points, out of a possible 10 points.

Your pockets are like your mindscape: vast but empty.

>x drinks
The drinks appear to be a variety of beers, wines, and spirits.

>x bardic troupe
On the south wall, a bardic troupe plays for the tavern while people dance in front of them.

>x dice and card players
On the north wall, the tavern door is painted around an actual closed door, and patrons sit at tables playing dice and cards.

>knock on closed door
You knock on the tavern door, but there is no answer.

>dance
You dance like nobody's watching, because no one is.

>i
Your pockets are like your mindscape: vast but empty.

>x ceiling
This is the UNDOT, not the Cistine Chapel!

>x metal slab
It's a partially descended metal slab, embedded within the wall.

>x floor
No need to be bashful!

>think about closed door
Only one puzzle left, and you still haven't translated the lettering on the statues, have you?

>think about statue lettering
You probably need some kind of book to translate them. Where have you seen books?

>x bartender
On the east wall, a bartender serves drinks to people sitting at the bar.

>s, down, w, n, n, n, n
Grand Balcony
You ascend the stairs to the grand balcony overlooking the foyer. There is a massive stone door, with an equally massive triangular lock system.

The Grand Foyer
You enter the grand foyer of the UNDOT, which is grand mostly because of the grand staircase leading up to a door with an imposing lock. There are also doors to the West Wing and East Wing of the castle. The old adventuring credo of the Left Hand Rule would suggest going to the West Wing first.

West Wing Foyer
You are standing in the foyer of the west wing of the UNDOT. A small pile of dust that used to be a skeleton sits under five levers in the "down" position. An open door to the north leads further into the west wing. An open door to the east leads back to the Grand Foyer. Also the statue of the bard is still there.

West Wing Hall
You step into a long hallway, with a red carpet running north along the floor. On the western side of the hall is a statue of a dragonkin barbarian clad in furs, with a large battle-axe across its back.

West Wing Hall 2
The carpet of the hall leads to a stone door, set into an archway covered with glyphs. A pile of dust lies in front of the door.

Pedestal Room
You enter a room dominated by four waist-high pedestals, arranged in a 2x2 pattern. To the north is a featureless stone door.

Mirrored Study
You enter a large study at the end of the west wing. The center is dominated by a dining table with seating and place settings for six. The northern wall has two bookshelves, separated by a writing desk. On the eastern wall is a large fireplace and mantle, flanked on one side by fireplace tools and on the other by a stone statue. The southern wall is decorated with ornamental weapons, and a suit of armor stands on either side of the southern door. The western wall is covered by a grand mirror that runs the entire width and height of the wall, and in front of the mirror lies a dead adventurer.

>x bookshelves
The bookshelves reach the height of the ceiling and, barring the space in between for the writing desk, cover the entire width of the wall. They seem to be sorted by author rather than subject, and no gaps indicate any missing books.

>x desk
It is a small writing desk with a single chair. A pot of ink and quill sits in a corner of the desk.

>search for a book to help decipher writing
I only understood you as far as wanting to look for a book.

>read books
You scan over the book spines, with most of the tomes being too dense or irrelevant to be worth notice. Near the end, however, you spot one that stands out. Just after "Volo's Guide to Monsters" you see "Volo's Guide to Spirits: Drinks and How to Order Them (In Any Language)".

>read Volo's drinks guide
It's too long to read in one sitting. Maybe you should just take it with you.

>read Volo's monsters guide
[Description removed by Hasbro]

>take Volo's drinks guide
Taken.

>x mug
You briefly peruse Volo's Guide to Spirits: Drinks and How to Order Them (In Any Language).

The lettering is the word "All" in the halfling tongue.

>x self
You are an Apprentice.

You currently are Irritated.

You currently have 9 points, out of a possible 10 points.

You are carrying:
  Volo's Guide to Spirits: Drinks and How to Order Them (In Any Language)

>s, s, s, s, e, s
Pedestal Room
You enter a room dominated by four waist-high pedestals, arranged in a 2x2 pattern. To the north is a featureless stone door.

West Wing Hall 2
The carpet of the hall leads to a stone door, set into an archway covered with glyphs. A pile of dust lies in front of the door.

West Wing Hall
You step into a long hallway, with a red carpet running north along the floor. On the western side of the hall is a statue of a dragonkin barbarian clad in furs, with a large battle-axe across its back.

West Wing Foyer
You are standing in the foyer of the west wing of the UNDOT. A small pile of dust that used to be a skeleton sits under five levers in the "down" position. An open door to the north leads further into the west wing. An open door to the east leads back to the Grand Foyer. Also the statue of the bard is still there.

The Grand Foyer
You enter the grand foyer of the UNDOT, which is grand mostly because of the grand staircase leading up to a door with an imposing lock. There are also doors to the West Wing and East Wing of the castle. The old adventuring credo of the Left Hand Rule would suggest going to the West Wing first.

UNDOT Entrance
You step onto the raised dais, and see the great stone double doors that lead into the UNDOT. Decorations are carved into the stonework near your feet. A marble statue torso, toppled and broken, lies in front of the door.

>x filigree pattern
You briefly peruse Volo's Guide to Spirits: Drinks and How to Order Them (In Any Language).

At first glance, it appears to be purely decorative. After a few moments of study, however, it appears there is lettering in the filigree. The lettering is the word "If you're not an Apprentice, don't waste your time out here!" in the gnomish tongue.

>s
Inner Courtyard
You find yourself surrounded on your left and right sides by white marble statues, eroded by time. Most are unrecognizable, but one statue of a treefolk person looking into the distance seems to have held up better than the others. Ahead of you, the stone path widens to a dais leading up to the castle doors. [ed. note - maybe add multiple floors if it's going to be a tower or castle.]

>x treefolk statue
You briefly peruse Volo's Guide to Spirits: Drinks and How to Order Them (In Any Language).

The treefolk statue stands tall, though its face is too weathered to read whether it is looking wistfully or expectantly into the distance. A few leaves carved in its hair have broken off, and its cloth garments suggest that this particular treefolk is no stranger to urban areas. As you look closer, it appears that one of the arms has lettering carved into it. The lettering is the word "We" in the sylvan tongue.

>n, n, w, n
UNDOT Entrance
You step onto the raised dais, and see the great stone double doors that lead into the UNDOT. Decorations are carved into the stonework near your feet. A marble statue torso, toppled and broken, lies in front of the door.

The Grand Foyer
You enter the grand foyer of the UNDOT, which is grand mostly because of the grand staircase leading up to a door with an imposing lock. There are also doors to the West Wing and East Wing of the castle. The old adventuring credo of the Left Hand Rule would suggest going to the West Wing first.

West Wing Foyer
You are standing in the foyer of the west wing of the UNDOT. A small pile of dust that used to be a skeleton sits under five levers in the "down" position. An open door to the north leads further into the west wing. An open door to the east leads back to the Grand Foyer. Also the statue of the bard is still there.

West Wing Hall
You step into a long hallway, with a red carpet running north along the floor. On the western side of the hall is a statue of a dragonkin barbarian clad in furs, with a large battle-axe across its back.

>x dragonkin
You briefly peruse Volo's Guide to Spirits: Drinks and How to Order Them (In Any Language).

It is a statue of a tall dragonkin barbarian, holding a two-handed axe in a position to swing downwards with a ferocious attack. Upon closer inspection, you see lettering in the scales on his chest. The lettering is the word "Are" in the draconic tongue.

>s, e, e, n, n, n, n, s, s
West Wing Foyer
You are standing in the foyer of the west wing of the UNDOT. A small pile of dust that used to be a skeleton sits under five levers in the "down" position. An open door to the north leads further into the west wing. An open door to the east leads back to the Grand Foyer. Also the statue of the bard is still there.

The Grand Foyer
You enter the grand foyer of the UNDOT, which is grand mostly because of the grand staircase leading up to a door with an imposing lock. There are also doors to the West Wing and East Wing of the castle. The old adventuring credo of the Left Hand Rule would suggest going to the West Wing first.

East Wing Foyer
You enter a small foyer much like the Grand Foyer, just smaller. It is unfurnished, with a stone door to the north and a sign above the door.

East Wing Chasm
As you enter the room, you see that the floor ahead drops away suddenly into a deep chasm that stretches the entire width of the room. The ceiling above the chasm extends upward fifty feet. Hanging from that ceiling, you see several wooden platforms suspended on chains. The platforms seem to form a bridge across the chasm. Near the wall to the east, you see a group of six chains hanging from the ceiling. Each chain has a circular medallion hanging from the end of it.

East Wing Hallway
You step into a long, carpeted hallway. A single sconce illuminates the immediate area, while the rest of the hallway disappears into darkness to the north.

Darkness
It is pitch black. You are likely to be eaten by a grue.

Darkness
It is pitch black. You are likely to be eaten by a grue.

Darkness
It is pitch black. You are likely to be eaten by a grue.

East Wing Hallway, North
You approach a closed door illuminated by a single sconce. In the northwest corner of the room, you see a statue of an elven ranger with a bow and quiver slung across her back, arms spread wide in a friendly gesture.

>x statue
You briefly peruse Volo's Guide to Spirits: Drinks and How to Order Them (In Any Language).

It is a stone statue of an elven ranger with a bow and quiver slung across her back, arms spread wide in a friendly gesture. Across her sleeve is some lettering. The lettering is the word "Together" in the elvish tongue.

>n
East Wing Vault
You enter what can only be described as a treasure vault belonging to a compulsive hoarder. The room is filled with stacks of boxes, chests of drawers, and safes all piled up in a way that looks barely stable, with narrow walkways between them. In one corner of the room, mannequins in armor are pressed together, while in another, statues are stacked and crammed together.

>x statue
You briefly peruse Volo's Guide to Spirits: Drinks and How to Order Them (In Any Language).

The distinctive statue is of a dwarf priest in long, flowing robes, with hands folded in prayer and a small book with lettering on the cover hanging from his belt. The lettering is the word "Key" in the dwarven tongue.

>s, s, s, n, n, s, s, w, up, n
East Wing Hallway, North
You approach a closed door illuminated by a single sconce. In the northwest corner of the room, you see a statue of an elven ranger with a bow and quiver slung across her back, arms spread wide in a friendly gesture.

Darkness
It is pitch black. You are likely to be eaten by a grue.

Darkness
It is pitch black. You are likely to be eaten by a grue.

Darkness
It is pitch black. You are likely to be eaten by a grue.

East Wing Hallway
You step into a long, carpeted hallway. A single sconce illuminates the immediate area, while the rest of the hallway disappears into darkness to the north.

East Wing Chasm
As you enter the room, you see that the floor ahead drops away suddenly into a deep chasm that stretches the entire width of the room. The ceiling above the chasm extends upward fifty feet. Hanging from that ceiling, you see several wooden platforms suspended on chains. The platforms seem to form a bridge across the chasm. Near the wall to the east, you see a group of six chains hanging from the ceiling. Each chain has a circular medallion hanging from the end of it.

East Wing Foyer
You enter a small foyer much like the Grand Foyer, just smaller. It is unfurnished, with a stone door to the north and a sign above the door.

The Grand Foyer
You enter the grand foyer of the UNDOT, which is grand mostly because of the grand staircase leading up to a door with an imposing lock. There are also doors to the West Wing and East Wing of the castle. The old adventuring credo of the Left Hand Rule would suggest going to the West Wing first.

Grand Balcony
You ascend the stairs to the grand balcony overlooking the foyer. There is a massive stone door, with an equally massive triangular lock system.

Fresco Room
You enter an unfurnished room, with a door in the north wall fresco concealed in a painted fresco that covers all four walls of the room. The fresco depicts a tavern full of people of all sorts of races and social standings. On the east wall fresco, a bartender serves drinks to people sitting at the bar. On the west wall fresco, tables and chairs are full of patrons drinking, singing, and laughing together. On the south wall fresco, a bardic troupe plays for the tavern while people dance in front of them. On the north wall fresco, the tavern door is painted around an actual door, and patrons sit at tables playing dice and cards.

>touch east wall
You feel nothing unexpected.

>x elven ranger
You can't see any such thing.

* * *

>touch elven ranger
You feel nothing unexpected.

>x elven ranger
The elven ranger is on the north wall, playing cards at a table.

>x sylvan
The treefolk is on the west wall, sitting at a table with a drink in its hand.

>touch tavern door
You feel nothing unexpected.

>touch sleeve of elven ranger
You feel nothing unexpected.

>think about translations
Everything about this puzzle is related to language, and your clues are all words...

>say together we are all the key
(to yourself)
Nothing happens.

>think about any missed areas
What missed areas?

>think about mural room
That isn't the only way to order those words into a sentence.

>say we are the key all together
(to yourself)
Nothing happens.

>say all together we are the key
(to yourself)
When you finish speaking, the door in the north wall slides open.

>say we the key are all together
(to yourself)
Nothing happens.

>say we are all the key together
(to yourself)
Nothing happens.

>n
UNDOT Peak
You enter a luxuriously appointed room with fine furniture and rugs. At the center of the room is a small round table with a scroll sitting atop it, labeled "READ ME". Off to one side is a bar with flutes of champagne and a charcuterie board.

>read scroll
The scroll reads:

Congratulations! You have worked together to achieve the first victory of - hopefully - many, paving the way for a new rise in Interactive Fiction with the addition of multiplayer! Your help has been instrumental in making this game a real product, and I couldn't have done it without you! I'd also like to take this opportunity to thank:

Steve "Jaspor" Orr and Bill Putrino, for writing the puzzles adapted here.
Bill Putrino, Christian Petermann, AeronDrake, and QalarValar for maps and images.
TwelveBaud, for writing and coding.
AFancyQuestionMark, Hal Incandenza, kaschei, Maerlyn, My Second Re-Reg, Opoponax, Tea Party Crasher, Your Personal Muse, and yuming, for being the first beta testers of this game.

Now go forth, and engage in jolly co-operation!

    *** The End ***

You currently have 10 points, out of a possible 10 points, earning you the rank of Novitiate.

Would you like to RESTART, RESTORE a saved game, QUIT or UNDO the last command?

>undo
UNDOT Peak
[Previous turn undone.]

>x charcuterie
It is a cheese board arranged with a delightful variety of cheeses, crackers, and cured meats.

On the charcuterie board are nine meat and cracker sandwiches.

>x champagne
The champagne looks pleasantly bubbly; the bar is probably enchanted to prevent the drinks from going flat.

>x self
You are an Apprentice.

You currently are Irritated.

You currently have 9 points, out of a possible 10 points.

You are carrying:
  Volo's Guide to Spirits: Drinks and How to Order Them (In Any Language)

>drink one champagne
(first taking the flute of champagne)
You drink the flute of champagne. A good vintage.
Having no further use for the glass, you cast it off the tower.

>eat all sandwiches
meat and cracker sandwich: (first taking the meat and cracker sandwich)
You eat the meat and cracker sandwich. Not bad.
meat and cracker sandwich: (first taking the meat and cracker sandwich)
You eat the meat and cracker sandwich. Not bad.
meat and cracker sandwich: (first taking the meat and cracker sandwich)
You eat the meat and cracker sandwich. Not bad.
meat and cracker sandwich: (first taking the meat and cracker sandwich)
You eat the meat and cracker sandwich. Not bad.
meat and cracker sandwich: (first taking the meat and cracker sandwich)
You eat the meat and cracker sandwich. Not bad.
meat and cracker sandwich: (first taking the meat and cracker sandwich)
You eat the meat and cracker sandwich. Not bad.
meat and cracker sandwich: (first taking the meat and cracker sandwich)
You eat the meat and cracker sandwich. Not bad.
meat and cracker sandwich: (first taking the meat and cracker sandwich)
You eat the meat and cracker sandwich. Not bad.
meat and cracker sandwich: (first taking the meat and cracker sandwich)
You eat the meat and cracker sandwich. Not bad.

* * *

>x self
You are an Apprentice.

You currently are Irritated.

You currently have 9 points, out of a possible 10 points.

You are carrying:
  Volo's Guide to Spirits: Drinks and How to Order Them (In Any Language)

>x bar
On the bar are a charcuterie board (on which are nine meat and cracker sandwiches) and sixteen flutes of champagne.

>x champagne
The champagne looks pleasantly bubbly; the bar is probably enchanted to prevent the drinks from going flat.

>eat all sandwiches
meat and cracker sandwich: (first taking the meat and cracker sandwich)
You eat the meat and cracker sandwich. Not bad.
meat and cracker sandwich: (first taking the meat and cracker sandwich)
You eat the meat and cracker sandwich. Not bad.
meat and cracker sandwich: (first taking the meat and cracker sandwich)
You eat the meat and cracker sandwich. Not bad.
meat and cracker sandwich: (first taking the meat and cracker sandwich)
You eat the meat and cracker sandwich. Not bad.
meat and cracker sandwich: (first taking the meat and cracker sandwich)
You eat the meat and cracker sandwich. Not bad.
meat and cracker sandwich: (first taking the meat and cracker sandwich)
You eat the meat and cracker sandwich. Not bad.
meat and cracker sandwich: (first taking the meat and cracker sandwich)
You eat the meat and cracker sandwich. Not bad.
meat and cracker sandwich: (first taking the meat and cracker sandwich)
You eat the meat and cracker sandwich. Not bad.
meat and cracker sandwich: (first taking the meat and cracker sandwich)
You eat the meat and cracker sandwich. Not bad.

>take one champagne flute
Taken.